abbout->about
accension->ascension
accesories->accessories
accuraccy->accuracy
acn->can
acommodated->accommodated
acomodate->accommodate
acomodated->accommodated
adaptating->adapting
additionnal->additional
admnistrative->administrative
agregation->aggregation
aisian->Asian
algroithm->algorithm
alos->also
amission->admission
amoutn->amount
andd->and
andthe->and the
anlalyze->analyze
annonced->announced
ansalisation->nasalization
apalling->appalling
aplyed->applied
appeares->appears
appraoch->approach
april->April
ar->are
arbritrary->arbitrary
asymetry->asymmetry
asymettric->asymmetric
athenean->Athenian
atheneans->Athenians
attritube->attribute
audiance->audience
august->August
automize->automatize
availabe ->available
balence->balance
becuse->because
beligum->Belgium
betwenn->between
bianries->binaries
bianry->binary
bilatteral->bilateral
blanacing->balancing
boxs->boxes
busineses->businesses
bve->be
caffiene->caffeine
caliberate->calibrate
caliberation->calibration
cant->can't
carmel->caramel
cas->case
changeing->changing
charcter->character
charcters->characters
charecter->character
charector->character
choosed->chosen
christmas->Christmas
cna->can
colection->collection
comapny->company
committy->committee
compair->compare
compleated->completed
completly->completely
computated->computed
computating->computing
comunicate->communicate
comunity->community
configuation->configuration
connexion->connection
consquently->consequently
constraitn->constraint
constrast->contrast
contrained->constrained
contraint->constraint
contraints->constraints
contratry->contrary
conveyer->conveyor
coonectivity->connectivity
coresponding->corresponding
cotten->cotton
councellor->councilor
councellors->councilors
cpoy->copy
critising->criticizing
critisising->criticizing
critisize->criticize
critisized->criticized
critisizes->criticizes
critisizing->criticizing
crticised->criticized
crystalisation->crystallization
cxan->can
danceing->dancing
december->December
deram->dream
despatched->dispatched
differant->different
differece->difference
Dijktra->Dijkstra
dilligence->diligence
dilligent->diligent
discared->discarded
doese->does
doller->dollars
dont->don't
driping->dripping
driveing->driving
droping->dropping
effcient->efficient
effciently->efficiently
ehr->her
eigth->eight
electic->electric
emition->emotion
emminent->imminent
emphaised->emphasized
endevour->endeavor
enoguh->enough
erally->really
excitment->excitement
exmaples->examples
explicitely->explicitly
exterme->extreme
eyt->yet
familar->familiar
february->February
feild->field
ficititious->fictitious
fied->field
fiel->file
fiels->files
firts->first
flase->false
flie->file
follwo->follow
fomr->form
foonote->footnote
friday->Friday
frmo->from
fro->for
fullfil->fulfill
fullfiling->fulfilling
fullfills->fulfills
functionnal->functional
fwe->few
gaem->game
geting->getting
giveing->giving
gloablly->globally
gruop->group
guaranted->guaranteed
guerilla->guerrilla
guerillas->guerrillas
haemorrage->hemorrhage
Hallowean->Halloween
haveing->having
hda->had
heigth->height
herat->heart
hge->he
hoem->home
homogenenous->homogeneous
homogenous->homogeneous
hsa->has
hsi->his
hte->the
idae->idea
ihs->his
imanent->imminent
imigrant->immigrant
imigrated->immigrated
imigration->immigration
iminent->imminent
impeech->impeach
impraticable->impracticable
indecate->indicate
indeferently->indifferently
indentify->identify
inspite->inspire
insted->intead
interbread->interbred
intered->interned
intersted->interested
inthe->in the
inumerable->innumerable
invisaged->envisaged
january->January
jewllery->jewelery
july->July
june->June
juste->just
labatory->laboratory
labled->labeled
laod->load
lateraly->laterally
launchs->launches
leanr->learn
librarry->library
librery->library
liev->live
likly->likely
linls->links
liveing->living
maching->matching
makeing->making
manuscrit->manuscript
mechanim->mechanism
mnay->many
monday->Monday
moreso->more so
multiconstrained->multi-constrained
muscels->muscles
mutiplication->multiplication
mutipl->multiple
mutualy->mutually
mysefl->myself
myu->my
necessarly->necessarily
necesserily->necessarily
neigbouring->neighboring
neigbour->neighbor
neigbours->neighbors
ni->in
ninties->nineties
november->November
nwe->new
nwo->now
occaisonally->occasionally
occasionnally->occasionally
october->October
oculd->could
ocur->occur
oftne->often
ohter->other
onot->not
opperation->operation
optoin->option
optoins->options
organistion->organization
orginized->organized
originall->originally
osme->some
osmething->something
os->so
ot->to
otu->out
pani->pain
performes->performs
personelle->personnel
personnal->personal
poeple->people
poitn->point
porblem->problem
prefixs->prefixes
proble->problem
profesion->profession
progrom->program
progroms->programs
protoge->protege
provisionning->provisioning
quater->quarter
queing->queuing
questoin->question
reachibility->reachability
reasonnable->reasonable
receieve->receive
recipie->recipe
recipies->recipes
reconize->recognize
redondancy->redundancy
redondant->redundant
relectant->reluctant
relized->realized
repatition->repartition
repect->respect
requirments->requirements
respondible->responsible
restraunt->restaurant
ro->or
russian->Russian
saturday->Saturday
sceptical->skeptical
seceeded->seceded
seceed->secede
seh->she
selectoin->selection
sentance->sentence
sepcific->specific
sepcify->specify
september->September
si->is
simulatation->simulation
simultion->simulation
sobor->sober
somehting->something
somethign->something
sotyr->story
sould->should
spanish->Spanish
speciallized->specialized
speicfic->specific
splitted->split
sqare->square
staisfying->satisfying
stnad->stand
straighforward->straightforward
strenghts->strengths
strentgh->strength
strucuture->structure
struggel->struggle
sunday->Sunday
surley->surely
surrended->surrendered
swich->switch
thansk->thanks
thinkin->thinking
thme->them
thursday->Thursday
ti->it
tipically->typically
tipical->typical
tolerence->tolerance
tollerance->tolerance
tollerate->tolerate
tollerence->tolerance
tonihgt->tonight
tourch->touch
tpyo->typo
traditionnally->traditionally
traditionnaly->traditionally
transimissions->transmissions
transimission->transmission
trhoughout->throughout
trhough->through
tuesday->Tuesday
turnk->trunk
tyhe->the
uesr->user
unsed->unused
vacumme->vacuum
vidoe->video
villin->villain
wednesday->Wednesday
weigth->weight
wekeend->weekend
wifi->Wi-Fi
wihch->which
wimax->WiMax
windoes->windows
withe->with
woh->who
worte->wrote
wrod->word
ws->was
wya->way
yacth->yacht
